Mishneh Torahמשנה תורה

    Introductionהקדמה
        Transmission of the Oral Law	מסירת תורה שבעל פה
        Positive Mitzvot	מצוות עשה
        Negative Mitzvot	מצוות לא תעשה
        Overview of Mishneh Torah Contents	תוכן החיבור

    Sefer Maddaספר מדע
        Foundations of the Torah	הלכות יסודי התורה
        Human Dispositions	הלכות דעות
        Torah Study	הלכות תלמוד תורה
        Foreign Worship and Customs of the Nations	הלכות עבודה זרה וחוקות הגויים
        Repentance	הלכות תשובה

    Sefer Ahavahספר אהבה
        Reading the Shema	הלכות קריאת שמע
        Prayer and the Priestly Blessing	הלכות תפילה וברכת כהנים
        Tefillin, Mezuzah and the Torah Scroll	הלכות תפילין ומזוזה וספר תורה
        Fringes	הלכות ציצית
        Blessings	הלכות ברכות
        Circumcision	הלכות מילה
        The Order of Prayer	סדר התפילה

    Sefer Zemanimספר זמנים
        Sabbath	הלכות שבת
        Eruvin	הלכות עירובין
        Rest on the Tenth of Tishrei	הלכות שביתת עשור
        Rest on a Holiday	הלכות שביתת יום טוב
        Leavened and Unleavened Bread	הלכות חמץ ומצה
        Shofar, Sukkah and Lulav	הלכות שופר וסוכה ולולב
        Sheqel Dues	הלכות שקלים
        Sanctification of the New Month	הלכות קידוש החודש
        Fasts	הלכות תעניות
        Scroll of Esther and Hanukkah	הלכות מגילה וחנוכה

    Sefer Nashimספר נשים
        Marriage	הלכות אישות
        Divorce	הלכות גירושין
        Levirate Marriage and Release	הלכות יבום וחליצה
        Virgin Maiden	הלכות נערה בתולה
        Woman Suspected of Infidelity	הלכות סוטה

    Sefer Kedushahספר קדושה
        Forbidden Intercourse	הלכות איסורי ביאה
        Forbidden Foods	הלכות מאכלות אסורות
        Ritual Slaughter	הלכות שחיטה

    Sefer Haflaahספר הפלאה
        Oaths	הלכות שבועות
        Vows	הלכות נדרים
        Nazariteship	הלכות נזירות
        Appraisals and Devoted Property	הלכות ערכים וחרמין

    Sefer Zeraimספר זרעים
        Diverse Species	הלכות כלאים
        Gifts to the Poor	הלכות מתנות עניים
        Heave Offerings	הלכות תרומות
        Tithes	הלכות מעשרות
        Second Tithes and Fourth Year's Fruit	הלכות מעשר שני ונטע רבעי
        First Fruits and other Gifts to Priests Outside the Sanctuary	הלכות ביכורים ושאר מתנות כהונה שבגבולין
        Sabbatical Year and the Jubilee	הלכות שמיטה ויובל

    Sefer Avodahספר עבודה
        The Chosen Temple	הלכות בית הבחירה
        Vessels of the Sanctuary and Those who Serve Therein	הלכות כלי המקדש והעובדין בו
        Admission into the Sanctuary	הלכות ביאת מקדש
        Things Forbidden on the Alter	הלכות איסורי המזבח
        Sacrificial Procedure	הלכות מעשה הקרבנות
        Daily Offerings and Additional Offerings	הלכות תמידים ומוספין
        Sacrifices Rendered Unfit	הלכות פסולי המוקדשין
        Service on the Day of Atonement	הלכות עבודת יום הכפורים
        Trespass	הלכות מעילה

    Sefer Korbanotספר קורבנות
        Paschal Offering	הלכות קרבן פסח
        Festival Offering	הלכות חגיגה
        Firstlings	הלכות בכורות
        Offerings for Unintentional Transgressions	הלכות שגגות
        Offerings for Those with Incomplete Atonement	הלכות מחוסרי כפרה
        Substitution	הלכות תמורה

    Sefer Taharahספר טהרה
        Defilement by a Corpse	הלכות טומאת מת
        Red Heifer	הלכות פרה אדומה
        Defilement by Leprosy	הלכות טומאת צרעת
        Those Who Defile Bed or Seat	הלכות מטמאי משכב ומושב
        Other Sources of Defilement	הלכות שאר אבות הטומאות
        Defilement of Foods	הלכות טומאת אוכלים
        Vessels	הלכות כלים
        Immersion Pools	הלכות מקואות

    Sefer Nezikimספר נזיקין
        Damages to Property	הלכות נזקי ממון
        Theft	הלכות גניבה
        Robbery and Lost Property	הלכות גזילה ואבידה
        One Who Injures a Person or Property	הלכות חובל ומזיק
        Murderer and the Preservation of Life	הלכות רוצח ושמירת נפש

    Sefer Kinyanספר קניין
        Sales	הלכות מכירה
        Ownerless Property and Gifts	הלכות זכייה ומתנה
        Neighbors	הלכות שכנים
        Agents and Partners	הלכות שלוחין ושותפין
        Slaves	הלכות עבדים

    Sefer Mishpatimספר משפטים
        Hiring	הלכות שכירות
        Borrowing and Deposit	הלכות שאלה ופיקדון
        Creditor and Debtor	הלכות מלווה ולווה
        Plaintiff and Defendant	הלכות טוען ונטען
        Inheritances	הלכות נחלות

    Sefer Shoftimספר שופטים
        The Sanhedrin and the Penalties within their Jurisdiction	הלכות סנהדרין והעונשין המסורין להם
        Testimony	הלכות עדות
        Rebels	הלכות ממרים
        Mourning	הלכות אבל
        Kings and Wars	הלכות מלכים ומלחמות